Ctrl+C	コピー
Ctrl+V	貼り付け
Ctrl+X	切り取り
Ctrl+Z	元に戻す
Ctrl+A	全選択
Ctrl+F	検索
Ctrl+T	新しいタブ
Ctrl+W	タブを閉じる
Ctrl+Shift+T	閉じたタブを開く
Ctrl+Tab	次のタブ
Ctrl+Shift+Tab	前のタブ
Ctrl+L	アドレスバーへ移動
Ctrl+R	再読み込み
F5	再読み込み
Ctrl+Shift+R	ハード再読み込み
Ctrl+D	ブックマークに追加
Ctrl+Shift+O	ブックマークマネージャ
Ctrl+J	ダウンロード
Ctrl+H	履歴
Ctrl+Shift+Delete	閲覧履歴データの削除
Ctrl+N	新しいウィンドウ
Ctrl+Shift+N	シークレットウィンドウ
F11	全画面表示
Ctrl+P	印刷
Ctrl+S	ページを保存
Ctrl+0	ズームをリセット
Ctrl+Plus	拡大
Ctrl+Minus	縮小
