Ctrl+C	コピー
Ctrl+V	貼り付け
Ctrl+X	切り取り
Ctrl+Z	元に戻す
Ctrl+Y	やり直し
Ctrl+S	上書き保存
F12	名前を付けて保存
Ctrl+P	印刷
Ctrl+F	検索
Ctrl+H	置換
Ctrl+A	全選択
Ctrl+B	太字
Ctrl+I	斜体
Ctrl+U	下線
Alt+Enter	セル内改行
Shift+Space	行選択
Ctrl+Space	列選択
Ctrl+PageUp	前のシートへ
Ctrl+PageDown	次のシートへ
Ctrl+Home	A1セルへ移動
Ctrl+End	データ範囲の右下へ
Shift+F11	新しいシートを挿入
Ctrl+1	セルの書式設定
Ctrl+Key+;	今日の日付を入力
Ctrl+Key+:	現在の時刻を入力
Delete	数式と値をクリア
